_____S_____
___.....___
__.__C__.__
_.__COC__._
__.__C__.__
___.....___