___C_____
__BtB____
__F_F____
_B..._B__
_B...bB__
_Mo..W__L
_Bm..bB__
___BB____
